4 4 4 4 4 4 4 4 4 4 4 4 4 4 4 4 4 4 4 4 4 4 4 4 4 4 4 4 4 4 4 4 4 4 4 4 4 4 4 4 4 4 4 4 4 4 4 4 4 4 4 4 4 4 4 4 4 4 4 4 4 4 4 4 4 4 4 4 4 4 4 4 4 4 4 4 4 4 4 4 4 4 4 4 4 4 4 4 4 4 4 4 4 4 4 4 4 4 4 4 4 4 4 4 4 4 4 4 4 4 4 4 4 4 4 4 4 4 4 4 
4 2 1 1 1 1 1 1 1 1 1 1 1 1 1 1 1 1 2 4 2 1 1 1 1 1 1 1 1 1 1 1 2 2 2 2 2 2 2 2 2 2 2 2 2 2 1 1 1 1 1 1 2 2 1 1 1 1 2 2 2 2 2 2 2 2 2 2 2 2 2 2 2 2 2 2 2 2 2 2 2 2 2 2 2 2 2 2 2 2 2 2 2 1 1 1 1 1 1 1 1 1 1 1 2 2 1 2 2 2 2 2 2 1 1 1 1 1 1 4 
4 1 1 1 1 1 1 1 1 2 2 2 2 1 1 1 1 1 1 4 1 1 1 1 1 2 2 2 1 1 1 1 1 1 2 2 2 2 2 2 2 2 2 2 1 1 1 2 2 2 2 2 2 2 2 2 2 1 1 2 2 2 2 2 2 2 2 2 2 2 2 2 2 2 2 2 2 2 2 1 1 1 1 1 1 1 1 1 1 1 1 1 1 1 2 2 2 2 2 2 2 2 2 1 1 1 1 2 2 2 2 1 1 1 2 2 2 2 1 4 
4 1 1 1 1 1 1 2 2 2 2 1 1 1 1 1 1 2 1 4 1 1 1 1 1 1 1 1 1 1 1 2 2 1 1 2 2 2 2 2 2 2 2 1 1 2 2 2 2 2 2 2 2 2 2 2 2 2 1 2 2 2 2 2 2 2 2 2 2 2 2 2 2 2 2 2 2 1 1 1 2 2 2 2 2 2 2 2 2 2 2 2 1 1 1 2 2 2 2 2 2 2 2 2 2 2 1 1 2 1 1 2 2 2 2 2 2 2 2 4 
4 1 2 1 1 1 1 2 2 2 1 1 2 1 1 1 1 1 1 4 2 1 2 1 1 2 2 2 1 1 1 1 1 1 1 1 1 1 1 1 1 2 2 1 2 2 2 2 2 2 2 2 2 2 2 2 2 2 1 2 2 2 2 2 2 2 2 2 2 2 2 2 2 2 2 2 1 1 2 2 2 2 2 2 2 2 2 2 2 2 1 1 1 1 1 1 1 1 1 1 1 1 1 1 1 1 1 1 1 1 1 1 1 1 2 2 2 2 2 4 
4 1 1 1 1 1 2 1 1 1 1 2 2 1 1 1 1 1 1 4 2 1 2 2 1 1 1 1 1 1 1 1 1 1 1 2 2 2 2 2 1 1 1 1 2 2 2 2 2 2 2 2 2 2 2 2 1 1 1 1 1 1 1 1 1 1 1 2 2 2 2 2 2 2 2 1 2 2 2 2 2 2 2 2 1 1 1 1 1 1 1 1 1 1 1 1 1 1 1 1 1 1 1 1 1 2 2 1 1 1 2 2 2 1 1 1 1 2 1 4 
4 2 1 1 1 1 1 1 1 1 1 1 1 1 1 2 2 2 1 4 1 1 1 1 1 1 1 1 1 1 1 1 1 1 2 2 2 2 2 2 2 1 1 1 2 2 2 2 2 2 2 2 1 1 1 1 1 1 2 2 2 2 2 2 2 2 1 1 1 2 2 2 2 2 2 1 2 2 2 2 2 2 1 1 1 2 1 1 1 2 2 1 1 1 1 1 1 2 2 2 1 1 1 1 1 1 1 1 1 1 1 1 1 1 1 1 1 1 1 4 
4 2 1 2 2 2 2 1 1 1 1 1 1 1 1 2 2 2 2 4 1 1 1 1 1 1 1 1 1 1 1 2 1 1 2 2 2 2 2 2 1 1 2 2 1 1 2 1 1 1 1 1 1 1 1 2 1 1 1 1 1 2 2 2 2 2 2 2 1 1 2 2 2 2 2 1 2 2 2 2 1 1 1 2 2 1 1 1 1 1 1 1 1 1 1 2 1 1 1 1 1 2 2 1 1 1 1 1 1 1 1 2 2 1 1 1 2 2 1 4 
4 2 1 2 2 2 2 2 1 1 1 1 1 1 1 1 1 2 2 4 2 1 1 1 1 1 1 2 2 2 1 1 1 1 1 1 1 1 1 1 1 2 2 2 1 1 1 1 1 1 1 1 2 1 1 1 1 2 2 2 1 1 2 2 2 2 2 2 2 1 2 2 1 1 1 1 1 1 1 1 1 1 1 1 1 1 2 2 2 2 1 1 1 2 1 1 1 1 1 1 1 1 2 2 1 1 1 1 1 2 1 1 1 2 2 2 1 1 1 4 
4 2 1 2 2 2 2 1 1 1 1 2 1 1 1 1 1 2 2 4 2 2 2 2 1 1 1 1 1 1 1 1 1 1 1 1 1 1 2 2 2 2 1 1 1 1 1 1 1 2 2 1 1 1 1 1 2 2 2 2 2 1 2 2 2 2 2 2 1 1 1 1 2 2 2 2 1 1 1 1 1 1 1 2 1 2 2 2 2 2 1 1 2 2 2 1 2 2 2 2 2 1 1 1 1 1 1 1 1 1 1 1 1 1 1 1 1 1 1 4 
4 2 1 2 2 2 1 1 1 1 2 1 1 1 2 1 1 2 1 4 2 2 2 2 1 1 1 1 1 1 1 1 1 1 1 2 2 1 1 1 1 1 1 2 1 2 2 2 1 1 1 1 1 1 1 1 1 1 1 1 1 1 1 1 1 1 1 1 1 1 1 2 2 2 2 1 1 1 1 1 2 2 1 1 1 2 2 2 2 2 1 1 2 1 1 2 2 2 2 2 2 2 1 1 1 1 1 2 1 1 2 2 2 2 1 2 2 2 1 4 
4 2 1 2 2 2 1 1 1 1 1 1 1 1 1 1 2 1 1 4 2 2 2 1 1 2 1 2 1 1 1 1 2 1 1 1 2 1 1 1 1 1 2 2 1 1 1 1 1 1 1 1 1 1 1 1 1 1 1 1 1 1 1 1 1 1 1 1 1 1 2 2 2 2 2 1 2 1 1 1 2 2 2 2 1 1 2 2 2 2 1 1 1 1 1 2 2 2 2 2 1 1 1 1 2 2 1 1 2 1 2 2 2 2 2 1 2 2 2 4 
4 2 1 2 1 1 1 1 1 1 1 1 1 2 1 1 1 1 2 4 2 2 1 1 2 2 1 1 1 1 1 1 1 1 2 1 1 1 2 1 2 2 2 2 2 2 2 2 1 1 1 1 1 2 1 2 2 1 2 1 1 2 1 1 1 1 1 1 1 1 1 2 2 2 1 1 2 2 1 1 1 2 2 2 1 1 1 2 2 2 1 1 1 1 1 2 2 2 1 1 1 2 1 2 1 1 1 2 1 1 2 2 2 2 2 1 2 2 2 4 
4 2 1 1 1 1 1 1 1 1 1 1 1 1 1 1 1 1 2 4 2 2 1 1 2 2 2 2 1 1 1 2 1 2 1 1 1 1 2 1 2 2 2 2 2 1 1 1 1 1 1 2 1 2 2 1 2 1 1 1 2 1 1 1 1 1 2 1 1 1 1 2 2 2 1 2 2 2 2 1 2 1 1 1 2 1 1 1 1 1 1 1 2 1 1 1 1 1 1 2 2 2 1 1 1 2 1 2 1 1 1 2 2 2 2 1 2 2 2 4 
4 2 1 1 1 1 1 1 1 1 1 1 1 2 1 1 2 1 1 4 2 2 2 1 1 2 2 2 1 1 1 1 1 1 1 1 2 2 2 1 1 1 1 1 1 1 1 1 1 1 1 1 1 1 1 1 1 1 1 1 1 1 2 2 1 2 1 1 1 1 1 2 2 2 1 1 1 2 2 1 1 2 2 1 1 1 1 1 1 1 1 1 1 1 1 1 1 1 1 1 1 1 1 2 2 1 1 1 1 1 1 2 2 2 2 1 2 2 2 4 
4 2 1 1 1 1 1 1 1 1 2 1 2 2 1 1 2 2 1 4 2 2 2 2 1 1 2 2 1 2 1 1 1 1 1 1 1 1 1 1 1 2 2 1 1 1 1 1 1 2 2 2 2 1 1 1 1 1 1 1 2 2 2 2 1 2 1 2 1 2 1 1 2 2 2 1 2 2 2 2 1 2 2 1 1 1 1 1 1 1 1 1 1 1 1 1 1 1 1 1 1 1 1 1 1 1 2 1 2 2 1 2 2 2 2 1 2 2 1 4 
4 2 1 1 1 2 1 1 1 2 2 1 1 1 1 1 1 2 1 4 2 2 1 1 2 2 1 1 1 1 1 1 1 1 1 1 1 1 1 1 1 1 1 2 2 2 2 1 2 2 2 2 2 1 1 1 1 2 1 1 2 2 2 2 1 1 2 1 1 1 1 1 1 1 2 1 1 2 2 1 1 1 1 1 2 2 2 1 2 2 2 2 1 1 2 1 2 2 2 2 2 2 2 1 2 2 2 1 2 1 1 2 2 2 1 1 2 2 1 4 
4 2 1 2 1 1 1 1 1 2 1 1 1 1 1 2 1 2 2 4 2 2 1 1 2 2 2 2 2 1 1 2 1 2 2 2 2 2 2 2 2 1 1 2 2 2 2 1 1 1 2 1 1 1 1 1 1 2 2 1 1 1 2 2 1 1 2 1 1 1 1 2 2 1 1 1 1 1 1 1 2 2 1 1 2 2 2 1 2 1 1 1 1 1 1 1 1 1 1 1 1 1 2 2 1 1 2 2 1 1 1 2 2 2 1 2 1 1 1 4 
4 1 1 2 1 1 1 1 2 1 1 1 1 1 1 2 1 2 1 4 2 2 1 1 2 1 1 1 1 1 1 1 1 1 1 1 1 2 2 2 2 2 2 1 1 1 1 2 2 1 1 1 1 1 1 1 2 2 2 1 2 1 1 1 1 2 2 1 1 2 1 2 2 2 2 2 2 1 1 2 2 2 2 1 1 1 1 1 1 2 2 2 2 2 1 1 1 1 2 2 2 2 1 1 1 1 1 1 1 1 1 2 2 1 1 1 1 2 2 4 
4 1 1 2 1 1 1 1 1 1 1 1 2 1 1 2 1 1 1 4 2 2 1 1 1 1 2 2 1 1 2 1 1 2 2 2 1 1 2 2 2 2 2 2 2 2 1 1 1 1 1 1 1 2 2 2 2 2 2 1 1 1 2 1 1 1 1 1 1 1 1 2 2 2 2 2 2 2 2 1 1 1 1 1 2 1 1 2 2 2 2 2 2 2 2 2 1 1 1 2 2 2 2 2 2 1 1 1 1 1 1 1 1 1 1 1 2 2 2 4 
4 1 1 1 1 1 1 1 1 1 1 2 2 2 1 1 1 1 2 4 2 2 1 1 2 2 2 2 1 1 2 1 2 2 2 2 2 1 1 1 4 4 4 4 4 4 4 4 4 4 4 4 4 4 4 4 4 4 4 4 2 1 1 1 1 1 1 1 1 1 4 4 4 4 4 4 4 4 4 4 1 1 1 1 1 1 2 1 1 1 4 4 4 4 4 4 4 4 4 4 1 1 1 1 1 1 1 1 1 1 4 4 4 4 4 4 4 4 4 4 
4 1 1 1 1 1 1 1 1 1 1 1 2 2 1 1 1 2 2 4 2 2 1 1 2 2 2 1 1 1 2 1 2 2 2 2 2 2 2 1 1 1 1 1 2 2 2 2 2 2 2 2 2 2 2 2 2 2 2 4 2 2 1 2 1 2 2 2 2 2 2 1 1 1 1 1 1 1 1 1 1 1 1 1 1 2 2 2 2 2 1 1 1 1 2 2 2 2 2 1 1 1 1 1 1 1 1 1 1 1 1 1 2 2 2 2 1 1 1 4 
4 2 1 1 1 1 1 1 1 2 1 1 1 1 1 1 1 1 2 4 2 2 1 1 2 2 1 1 2 1 2 1 2 2 2 2 2 2 2 1 1 2 2 1 2 2 2 2 1 1 1 1 1 2 2 2 2 2 2 4 2 1 1 2 1 1 2 2 2 2 2 1 1 1 2 2 2 2 2 2 2 2 2 2 1 1 1 1 2 2 2 2 1 1 1 1 1 1 1 1 1 1 1 1 1 1 1 1 1 2 1 1 1 1 1 1 1 2 2 4 
4 2 1 1 1 1 1 1 2 2 2 1 1 1 1 2 2 1 1 4 2 2 1 1 2 2 1 2 2 1 2 1 2 2 2 2 2 2 2 2 1 1 2 1 1 1 1 1 1 1 1 2 2 2 1 1 2 2 2 4 2 1 2 2 2 1 2 2 1 1 1 1 1 1 1 1 1 1 2 1 1 1 1 1 1 1 1 1 1 1 1 1 1 1 1 1 1 1 1 1 1 1 1 2 2 2 2 2 1 1 1 1 1 1 2 2 2 2 2 4 
4 2 2 1 1 1 1 1 1 2 1 1 1 1 1 2 2 2 1 4 2 2 1 1 2 1 1 2 2 2 1 1 1 1 1 1 1 1 1 1 1 1 1 1 1 2 2 2 2 2 2 2 2 2 2 1 2 2 2 4 2 1 2 2 2 1 1 1 1 2 2 2 2 2 2 2 2 2 1 1 1 2 2 2 2 1 1 1 1 1 2 2 2 1 1 1 1 1 1 1 1 1 1 1 2 2 1 1 1 1 1 1 1 1 2 2 2 2 2 4 
4 2 2 1 1 1 1 2 1 1 1 1 1 1 1 2 2 2 1 4 2 2 1 1 2 1 2 2 1 1 1 2 1 2 2 1 1 1 1 1 2 1 1 1 1 2 2 2 2 2 2 2 2 2 2 1 2 2 2 4 2 1 1 1 1 1 1 1 1 1 1 1 1 1 1 1 1 1 1 1 1 1 1 1 1 2 2 2 1 1 2 2 2 2 1 1 2 2 2 2 2 2 2 1 1 1 1 2 2 1 1 1 1 1 1 2 2 2 2 4 
4 2 2 1 1 1 1 1 2 1 2 1 1 1 1 1 2 1 2 4 1 2 1 1 1 1 2 1 1 1 1 1 1 2 1 1 2 2 2 1 1 1 2 1 1 1 1 1 1 1 1 1 2 2 2 1 2 2 2 4 1 1 1 1 1 1 1 1 1 1 1 2 2 2 2 2 2 2 1 1 1 1 1 1 2 2 1 1 1 2 2 2 2 1 1 2 2 2 2 1 1 1 1 1 1 1 1 1 1 1 1 1 1 1 1 2 1 2 2 4 
4 2 2 2 1 1 1 1 2 1 1 1 1 1 1 1 1 1 2 4 1 1 1 1 1 2 1 1 2 1 2 1 1 1 1 2 2 1 1 1 1 1 1 1 1 1 2 1 1 1 1 1 1 2 2 1 1 1 1 4 2 1 1 2 1 1 1 1 1 1 1 1 1 1 1 1 2 1 1 1 1 1 1 1 1 1 2 2 2 2 2 2 2 1 2 2 2 1 1 2 2 2 2 2 1 2 1 1 1 1 1 2 1 1 1 1 1 2 2 4 
4 2 2 1 1 1 1 1 1 1 1 1 1 1 1 1 2 2 2 4 1 1 1 1 1 1 1 2 1 1 2 2 1 1 1 1 1 1 1 1 1 1 1 2 2 1 1 1 2 2 2 1 1 1 2 1 1 2 2 4 1 1 1 1 1 1 1 1 1 1 2 2 1 1 1 1 2 1 1 1 1 1 1 1 1 1 1 1 1 1 1 1 1 1 1 1 1 1 1 1 1 2 2 1 1 1 1 1 1 2 1 1 1 1 1 1 1 1 2 4 
4 2 2 1 1 1 1 1 1 1 1 1 1 2 1 1 2 2 2 4 1 1 1 1 1 1 1 1 1 2 2 2 1 1 1 1 1 1 2 2 1 1 1 1 2 1 1 2 2 2 2 1 2 1 1 1 1 2 2 4 1 2 1 1 1 1 1 1 2 1 1 2 2 1 1 1 1 1 1 1 2 1 1 1 1 1 1 1 2 1 1 2 2 1 2 1 1 2 2 2 2 1 1 1 1 2 1 1 2 2 2 1 1 1 1 1 1 1 1 4 
4 2 2 1 1 2 1 1 1 1 1 2 2 2 1 1 2 2 2 4 1 1 1 1 2 2 1 1 1 2 2 2 1 1 1 1 1 1 1 1 1 1 2 1 1 1 1 2 2 2 2 1 1 1 1 2 1 2 1 4 2 2 1 1 2 1 1 2 2 2 1 2 1 1 1 1 2 1 1 1 1 2 2 1 1 1 1 1 2 2 4 4 4 4 4 4 4 4 4 4 2 2 1 1 1 2 1 2 2 2 2 1 1 1 1 1 1 1 2 4 
4 2 2 1 1 2 1 1 1 1 1 1 2 2 1 1 2 2 1 4 1 1 1 1 2 1 1 2 1 1 1 2 1 1 1 2 1 1 1 1 2 1 1 1 1 2 1 1 2 2 2 1 1 1 2 2 1 2 1 4 2 1 1 1 1 1 1 1 2 2 1 1 1 1 1 1 1 1 1 2 2 2 1 1 1 1 1 2 1 2 4 1 1 1 1 1 2 2 2 4 2 2 1 1 1 1 1 1 1 1 1 1 1 1 1 1 1 2 1 4 
4 2 2 1 1 2 1 1 1 1 2 1 1 1 1 1 2 2 1 4 1 1 1 2 2 1 1 1 2 1 1 1 1 1 1 1 2 1 1 1 1 1 1 2 1 2 2 1 1 1 1 1 1 1 1 1 1 1 1 4 2 1 1 1 1 1 2 1 1 1 1 1 1 1 1 1 1 1 1 2 2 2 1 1 1 1 1 1 2 1 4 2 1 2 1 1 2 2 2 4 2 2 1 1 2 1 1 1 1 1 1 1 1 1 1 1 1 1 1 4 
4 2 2 1 1 1 1 1 1 1 1 1 1 1 1 2 2 2 1 4 1 1 2 2 2 1 1 1 1 1 1 1 1 1 1 1 1 1 1 1 1 1 1 2 1 1 1 1 1 1 1 1 1 1 2 2 1 1 2 4 2 1 2 1 1 1 2 2 2 1 1 1 2 2 2 2 1 1 1 2 2 1 1 1 1 1 2 1 2 1 4 1 2 2 1 1 1 2 2 4 2 2 1 1 1 1 1 2 1 1 1 1 1 1 1 2 1 1 1 4 
4 2 2 1 1 1 1 1 1 2 1 1 1 1 1 1 2 2 2 4 1 1 2 2 2 2 1 1 2 2 2 1 2 2 1 1 2 2 1 1 1 2 2 2 1 1 2 2 2 1 1 1 1 2 2 1 1 1 2 4 2 1 2 1 1 2 2 1 1 1 2 1 2 2 2 2 1 1 1 2 2 1 1 1 1 2 2 1 2 1 4 1 2 2 2 1 1 1 2 4 2 2 1 1 1 1 1 1 1 1 1 1 2 1 1 1 1 1 1 4 
4 2 2 2 1 1 1 1 1 1 1 1 2 1 2 1 2 2 2 4 1 1 2 1 1 2 2 1 2 2 2 1 2 2 1 1 1 1 1 2 1 2 2 1 1 1 2 1 1 1 1 1 2 2 2 1 1 1 2 4 2 1 2 2 1 2 1 1 2 2 1 1 2 2 2 2 1 1 1 1 1 1 1 1 2 2 2 1 2 2 4 1 2 2 2 2 1 1 1 4 2 1 1 1 1 1 1 2 2 1 1 2 2 1 2 1 1 2 1 4 
4 2 2 2 1 1 1 2 2 1 1 1 1 1 1 1 1 2 2 4 1 1 2 1 1 1 2 1 1 2 2 1 2 2 2 2 1 2 2 2 1 2 2 1 2 1 1 1 1 1 1 1 1 2 2 1 1 1 2 4 2 1 2 2 1 1 1 1 2 2 1 2 2 2 2 2 1 1 1 1 1 1 1 1 2 2 2 1 2 1 4 1 2 2 2 2 2 2 1 4 1 1 1 1 1 1 1 1 1 2 2 2 1 1 2 1 1 2 1 4 
4 2 2 2 2 1 1 1 1 2 2 1 1 1 1 2 1 1 2 4 1 1 1 1 1 2 2 2 1 1 1 1 1 1 1 2 1 1 2 2 1 2 2 1 1 1 1 1 1 1 1 1 1 1 1 1 1 1 2 4 2 2 1 1 1 1 1 1 1 1 1 1 1 1 2 2 1 1 1 1 1 1 2 1 2 2 1 1 2 1 4 2 2 2 2 2 2 2 2 4 1 1 1 1 1 1 1 1 1 1 2 1 1 2 1 1 1 2 1 4 
4 2 2 2 1 1 1 1 1 2 2 2 1 1 2 2 2 1 2 4 1 1 1 1 1 1 1 2 1 1 1 2 1 2 1 2 2 1 2 2 1 2 1 1 1 1 1 1 1 1 2 2 1 1 1 1 1 2 1 4 2 2 1 1 1 1 1 1 1 1 1 1 1 1 1 1 1 1 1 1 1 1 1 1 2 2 1 1 1 1 4 2 2 2 2 2 2 2 2 4 2 1 2 2 1 1 1 1 2 1 1 1 2 2 1 1 1 2 1 4 
4 2 1 1 1 1 1 1 1 2 2 2 1 1 1 2 2 1 2 4 1 1 1 2 1 2 1 1 1 1 1 1 1 1 1 2 2 1 1 2 1 1 1 1 1 1 1 1 1 1 2 2 1 1 1 1 1 2 1 4 2 2 1 1 1 1 1 1 1 2 1 1 1 1 1 1 1 1 1 1 1 1 1 1 1 1 1 1 1 2 4 4 4 4 2 2 4 4 4 4 2 1 2 1 1 1 1 1 1 1 1 1 1 2 1 1 1 1 2 4 
4 2 1 2 2 1 2 1 1 2 2 1 1 2 1 2 2 1 2 4 1 1 1 1 1 2 1 1 1 1 1 1 1 1 1 1 1 1 1 1 1 1 1 1 1 1 1 1 1 1 1 2 2 1 1 1 1 2 1 4 2 2 1 1 1 1 1 1 1 1 1 1 1 1 1 1 1 1 1 2 2 2 1 1 1 1 1 1 1 1 1 1 1 2 2 1 1 1 1 1 1 1 1 1 1 1 1 1 2 2 2 2 1 2 2 2 1 1 2 4 
4 2 1 1 1 1 1 1 1 1 2 1 2 2 1 2 2 1 2 4 1 1 1 1 1 2 1 1 1 1 1 1 2 1 1 1 1 2 1 1 1 2 1 1 1 1 1 1 2 2 1 1 2 2 1 1 1 1 2 4 1 2 1 1 1 1 1 1 1 2 1 1 1 1 1 1 1 1 1 1 1 1 1 2 2 1 1 1 2 2 2 2 2 1 1 1 2 2 2 1 1 1 1 2 1 1 1 1 1 2 2 2 1 1 2 2 1 1 2 4 
4 2 2 2 1 1 1 1 2 1 1 1 2 2 1 1 2 1 2 4 1 1 1 2 1 1 1 2 1 1 2 2 2 2 1 1 1 1 1 1 1 1 2 1 1 1 2 1 2 2 2 1 1 2 1 1 1 1 1 4 1 1 1 1 1 1 1 1 1 1 1 1 1 1 1 1 1 1 2 1 2 2 1 1 1 1 2 2 1 1 1 1 1 1 1 1 1 1 1 1 2 2 1 1 1 1 1 1 1 2 2 2 2 1 2 1 2 1 2 4 
4 2 2 2 1 1 1 1 1 2 2 1 1 1 2 1 2 1 2 4 1 2 1 2 2 1 1 1 1 2 2 2 1 1 1 2 2 2 2 2 1 1 1 1 1 2 2 1 2 2 2 2 1 1 1 1 1 2 2 4 1 1 1 1 1 1 1 1 1 1 1 1 1 2 2 1 2 1 1 1 1 1 1 1 1 1 2 2 2 2 2 1 1 2 2 2 2 1 1 1 1 1 1 1 1 1 1 1 1 1 1 2 2 1 1 1 2 1 2 4 
4 2 1 1 1 2 2 1 1 1 2 1 1 2 1 1 2 1 1 4 2 2 1 2 2 1 1 1 2 2 1 1 1 1 1 1 1 1 2 2 2 1 1 1 1 2 2 1 2 2 2 2 1 2 1 1 1 2 2 4 1 1 2 1 1 2 1 1 1 2 2 1 1 1 1 1 1 1 1 1 1 1 2 2 2 1 1 2 2 2 2 1 1 1 1 1 1 1 1 1 2 1 1 1 1 1 1 1 1 1 1 1 1 1 1 2 1 1 2 4 
4 2 1 2 2 2 2 1 1 1 1 1 2 2 1 2 2 2 1 4 2 2 1 1 1 1 1 1 2 2 2 2 2 2 2 2 1 1 1 1 1 1 1 1 1 1 1 1 1 2 2 2 1 1 1 2 1 2 2 4 1 1 2 1 2 1 1 1 1 2 1 5 5 5 5 5 1 1 1 1 1 2 2 1 1 1 1 1 2 2 1 1 1 2 1 1 1 1 1 1 1 1 1 1 1 2 2 2 1 1 2 1 1 1 2 2 1 2 2 4 
4 2 1 2 2 2 2 2 1 2 1 1 2 1 1 1 2 2 1 4 1 1 1 1 1 1 1 2 2 2 2 2 2 2 2 1 1 1 2 2 2 1 1 1 1 1 1 1 1 1 1 1 1 1 2 2 1 1 1 4 1 1 1 1 1 2 2 1 1 5 5 5 5 5 5 5 1 1 1 1 1 1 2 2 2 2 1 1 1 2 1 2 1 1 1 1 1 2 2 1 1 1 2 1 1 2 2 2 1 1 1 1 1 1 1 2 1 1 2 4 
4 2 1 1 2 2 2 2 1 1 1 1 2 1 2 1 2 2 1 4 2 2 1 1 1 1 1 1 1 1 1 1 1 1 1 1 2 1 2 2 2 1 2 2 1 1 1 2 1 1 1 1 1 2 2 1 1 1 2 4 1 2 1 1 2 2 2 1 2 5 5 6 6 6 5 5 5 1 2 2 1 1 1 1 2 2 1 2 2 2 1 2 1 1 1 1 2 2 2 1 1 1 1 2 1 2 2 1 1 1 1 1 2 1 1 2 2 1 1 4 
4 2 2 1 1 1 2 2 1 1 2 1 1 1 2 1 1 2 1 4 2 2 2 2 2 2 2 2 2 2 2 2 2 2 2 2 2 1 1 1 1 1 2 2 1 1 1 1 1 1 1 1 1 2 2 1 1 1 2 4 1 2 1 1 1 2 2 1 5 5 5 6 6 6 5 5 5 1 1 2 1 1 1 1 1 1 1 1 1 1 2 2 1 2 2 1 2 2 2 2 1 1 1 1 1 2 1 1 1 1 1 1 1 1 1 1 1 1 2 4 
4 2 2 2 2 1 1 1 1 2 1 1 1 2 2 1 1 1 1 4 4 4 4 4 4 4 4 4 4 4 4 4 4 4 4 4 4 4 4 4 2 1 1 1 1 1 1 1 1 1 1 1 1 2 2 1 1 2 2 4 1 1 1 1 1 1 1 5 5 5 6 6 6 6 5 5 1 1 1 1 1 1 2 2 1 1 1 1 1 1 2 2 1 1 1 1 1 2 2 1 1 2 1 1 1 1 1 2 2 1 1 1 1 1 1 1 2 1 2 4 
4 2 1 1 1 1 1 1 1 1 1 1 1 1 1 1 2 2 2 2 2 2 2 1 1 1 1 2 2 2 2 2 2 2 2 2 2 2 2 2 2 2 1 1 2 1 1 1 1 1 1 2 1 1 2 1 1 2 2 4 1 1 2 2 1 2 5 5 5 5 6 6 6 6 5 2 2 2 2 1 1 1 1 1 1 1 2 2 2 1 1 1 1 1 1 1 1 1 1 1 1 1 1 1 1 1 1 2 1 1 1 1 1 2 1 2 2 1 2 4 
4 1 1 2 1 1 1 1 1 2 1 2 1 1 1 1 1 1 1 2 2 1 1 1 2 2 1 1 2 2 2 2 2 2 2 2 2 2 2 2 2 2 2 1 1 1 1 1 1 1 1 1 2 1 2 1 1 2 2 4 1 1 2 2 1 2 5 5 5 6 6 5 5 5 5 2 2 2 2 1 1 2 1 1 1 2 2 2 1 1 1 1 1 2 1 1 1 1 1 1 1 1 1 1 2 1 1 1 1 1 1 1 2 1 1 2 2 1 2 4 
4 1 1 2 1 1 1 1 1 2 1 2 1 2 1 1 2 2 1 1 1 1 1 1 2 2 1 1 2 2 2 2 2 2 2 2 2 2 2 2 2 2 2 1 1 1 1 1 1 2 2 1 1 1 1 2 1 2 2 4 1 1 2 2 1 5 5 5 6 6 5 5 5 2 2 2 2 2 1 1 2 2 1 1 1 1 1 1 1 2 1 1 1 1 1 1 1 2 1 1 1 1 1 1 1 1 1 1 1 1 1 1 2 1 1 2 1 1 2 4 
4 1 1 2 2 1 1 2 1 1 1 2 1 2 1 1 1 2 2 2 2 2 1 1 1 1 1 2 2 2 2 2 2 2 2 2 2 2 2 2 2 2 1 1 2 2 2 1 2 2 2 2 1 1 1 2 1 2 2 4 1 1 1 2 2 5 5 6 6 5 5 1 1 1 2 2 2 1 1 2 2 1 1 1 2 1 1 1 1 1 1 1 1 1 1 1 1 1 1 1 1 1 1 1 1 1 1 1 1 1 1 1 1 1 1 1 1 2 1 4 
4 1 2 2 2 1 1 2 2 1 1 1 1 2 1 1 1 1 2 2 2 2 1 1 1 1 1 1 1 1 1 1 1 1 1 2 1 1 1 2 2 1 1 2 2 2 1 1 2 2 2 2 2 1 1 2 1 1 2 4 1 2 1 2 1 5 6 6 5 5 2 2 2 1 1 1 1 1 2 2 2 1 1 2 2 2 1 2 1 1 1 1 1 1 1 1 1 1 1 1 1 1 1 1 1 1 1 1 2 2 2 1 1 1 1 1 1 2 1 4 
4 1 2 2 2 1 1 2 2 2 1 1 1 1 1 2 2 1 2 2 2 2 1 2 1 1 1 1 1 1 2 2 1 1 1 1 1 2 1 1 2 1 2 2 2 2 1 2 2 2 2 2 2 1 1 2 2 1 2 4 1 2 1 1 5 5 6 5 5 2 2 2 2 2 2 1 1 1 1 1 1 2 2 2 2 2 1 1 1 2 2 1 2 2 1 1 1 1 1 1 1 1 1 1 1 1 2 2 2 1 1 1 1 1 1 1 1 1 2 4 
4 1 1 2 1 1 1 1 1 1 1 1 1 1 1 2 2 1 1 2 2 1 1 1 1 2 1 1 1 1 1 1 1 1 2 1 1 2 2 1 1 1 2 2 2 1 1 2 2 2 2 2 1 1 1 2 2 2 1 4 1 1 2 1 5 6 6 5 1 2 2 2 2 2 2 1 2 1 1 1 1 1 1 1 2 1 1 1 2 2 2 1 1 1 2 1 1 1 1 2 1 1 1 1 1 2 2 1 1 1 1 1 1 2 2 1 1 2 2 4 
4 2 1 1 1 2 1 1 1 1 1 1 1 2 1 1 2 2 1 1 2 1 2 1 2 2 1 2 1 1 1 1 1 1 1 1 1 1 1 1 1 2 2 2 2 2 2 2 2 2 2 1 1 1 1 1 2 2 1 4 2 1 1 5 5 5 5 5 1 2 2 2 2 2 1 1 1 1 1 2 2 2 2 1 1 1 2 1 1 2 1 1 1 2 2 2 1 1 1 2 1 1 1 2 1 1 1 1 2 1 1 2 1 1 1 1 1 1 2 4 
4 2 2 1 1 2 1 2 2 1 1 1 2 2 2 1 2 2 2 1 1 1 2 1 1 1 1 1 1 2 1 2 1 1 1 1 1 1 1 1 1 2 2 2 2 2 1 1 1 1 1 1 1 2 1 1 2 2 2 4 1 1 1 5 5 5 5 1 1 1 1 1 1 1 1 1 1 1 2 2 2 2 2 1 1 1 1 1 1 1 1 2 2 2 2 2 2 1 1 1 1 2 1 1 1 1 2 1 1 1 2 1 1 1 1 1 1 1 1 4 
4 2 2 1 1 2 2 2 2 1 1 1 1 1 1 1 1 1 1 2 1 1 2 2 1 1 1 1 1 1 1 1 1 2 1 1 1 2 2 1 1 1 1 1 1 1 1 2 2 2 1 1 2 2 1 1 2 2 2 4 1 1 1 1 5 5 2 2 1 1 1 1 1 1 1 1 2 2 2 2 2 1 1 1 1 1 2 2 1 1 1 2 2 2 2 2 2 2 1 1 1 1 1 1 1 1 1 1 1 1 1 1 1 1 1 2 1 2 1 4 
4 2 1 1 1 2 2 2 2 1 1 1 1 1 2 1 2 2 1 1 1 1 1 1 1 2 2 1 1 1 1 1 1 1 1 2 2 2 2 2 1 2 2 1 1 1 1 2 2 1 1 1 2 1 1 1 2 2 2 4 1 2 2 1 5 5 1 1 1 1 1 1 1 1 1 1 1 1 1 1 1 1 1 2 2 2 1 1 1 1 1 1 2 2 2 2 2 1 1 2 1 1 1 2 2 2 2 2 2 1 1 1 1 1 2 2 1 2 1 4 
4 1 1 2 1 2 2 2 1 1 1 1 1 1 1 1 1 1 1 1 2 2 2 1 1 1 1 1 1 1 1 2 2 1 1 1 2 2 2 2 1 2 2 1 1 1 2 2 1 1 1 1 1 1 1 2 2 2 2 4 1 2 2 2 1 1 2 2 2 2 1 1 2 1 1 2 2 2 2 2 2 2 2 2 2 1 1 2 2 2 2 1 1 2 2 2 1 2 1 1 1 1 1 2 2 1 1 1 1 1 1 1 1 1 1 1 1 2 1 4 
4 2 1 2 1 2 1 1 1 2 1 2 2 1 1 1 1 1 2 2 2 2 2 2 2 2 2 2 2 2 1 1 1 2 2 1 1 1 1 1 1 1 1 1 1 1 1 1 1 1 1 1 2 1 1 2 2 2 2 4 1 2 2 2 2 2 1 1 1 2 2 1 1 2 1 1 1 2 2 2 2 2 1 1 1 2 2 2 2 2 2 2 1 1 1 1 1 1 1 1 1 2 1 1 2 2 2 2 2 2 2 2 2 2 1 1 1 2 1 4 
4 1 1 2 1 1 1 2 1 1 1 1 1 1 1 1 2 2 2 2 2 2 2 2 2 2 2 2 2 2 2 2 1 1 1 2 2 2 2 1 1 1 1 1 2 2 2 2 2 1 1 2 1 1 2 2 2 2 2 4 1 2 2 2 1 1 1 2 1 1 1 1 1 1 1 1 1 1 1 1 1 1 1 1 1 1 1 1 1 1 1 1 1 1 1 1 1 1 1 1 1 1 1 1 1 1 1 2 2 2 2 2 1 1 1 1 2 1 1 4 
4 1 2 2 1 1 1 1 1 1 1 1 1 1 2 2 2 2 2 2 2 2 2 2 2 2 2 2 2 2 2 2 2 2 1 1 1 1 1 1 1 1 2 2 2 2 2 2 2 2 1 1 1 2 2 2 2 2 2 4 1 1 1 1 1 2 2 2 2 2 2 2 1 1 1 1 1 1 1 2 1 1 1 1 1 1 1 1 1 1 2 2 2 2 2 2 1 1 1 1 1 2 2 2 2 1 1 1 1 1 1 1 1 1 1 2 1 1 2 4 
4 2 1 1 1 2 2 2 2 2 2 2 2 2 2 2 2 2 2 2 2 2 2 2 2 2 2 2 2 2 2 2 2 2 2 2 2 2 2 2 2 2 2 2 2 2 2 2 2 2 2 2 2 2 2 2 2 2 2 4 2 2 2 2 2 2 2 2 2 2 2 2 2 2 2 2 1 1 1 1 2 2 2 2 2 2 2 2 2 2 2 2 2 1 1 1 2 2 2 2 1 1 1 1 1 1 1 1 1 1 1 1 1 1 1 1 1 2 2 4 
4 4 4 4 4 4 4 4 4 4 4 4 4 4 4 4 4 4 4 4 4 4 4 4 4 4 4 4 4 4 4 4 4 4 4 4 4 4 4 4 4 4 4 4 4 4 4 4 4 4 4 4 4 4 4 4 4 4 4 4 4 4 4 4 4 4 4 4 4 4 4 4 4 4 4 4 4 4 4 4 4 4 4 4 4 4 4 4 4 4 4 4 4 4 4 4 4 4 4 4 4 4 4 4 4 4 4 4 4 4 4 4 4 4 4 4 4 4 4 4