6 2 3 3 2 2 2 2 2 6 6 2 2 2 3 2 2 2 2 6 6 2 3 3 2 2 2 2 2 6 6 2 2 2 3 2 2 2 2 6 6 2 3 3 2 2 2 2 2 6 6 2 2 2 3 2 2 2 2 6 6 2 3 3 2 2 2 2 2 6 6 2 2 2 3 2 2 2 2 6 6 2 3 3 2 2 2 2 2 6 6 2 2 2 3 2 2 2 2 6
2 6 3 2 2 2 2 2 6 3 2 6 6 2 2 2 2 2 6 2 2 6 3 2 2 2 2 2 6 3 2 6 6 2 2 2 2 2 6 2 2 6 3 2 2 2 2 2 6 3 2 6 6 2 2 2 2 2 6 2 2 6 3 2 2 2 2 2 6 3 2 6 6 2 2 2 2 2 6 2 2 6 3 2 2 2 2 2 6 3 2 6 6 2 2 2 2 2 6 2
3 3 6 2 2 2 3 6 3 2 3 3 6 2 2 2 2 6 2 2 3 3 6 2 2 2 3 6 3 2 3 3 6 2 2 2 2 6 2 2 3 3 6 2 2 2 3 6 3 2 3 3 6 2 2 2 2 6 2 2 3 3 6 2 2 2 3 6 3 2 3 3 6 2 2 2 2 6 2 2 3 3 6 2 2 2 3 6 3 2 3 3 6 2 2 2 2 6 2 2
3 2 3 6 2 3 6 3 3 2 2 2 2 6 2 2 6 2 2 2 3 2 3 6 2 3 6 3 3 2 2 2 2 6 2 2 6 2 2 2 3 2 3 6 2 3 6 3 3 2 2 2 2 6 2 2 6 2 2 2 3 2 3 6 2 3 6 3 3 2 2 2 2 6 2 2 6 2 2 2 3 2 3 6 2 3 6 3 3 2 2 2 2 6 2 2 6 2 2 2
2 2 2 3 6 6 3 3 2 2 2 3 2 2 6 6 2 2 3 2 2 2 2 3 6 6 3 3 2 2 2 3 2 2 6 6 2 2 3 2 2 2 2 3 6 6 3 3 2 2 2 3 2 2 6 6 2 2 3 2 2 2 2 3 6 6 3 3 2 2 2 3 2 2 6 6 2 2 3 2 2 2 2 3 6 6 3 3 2 2 2 3 2 2 6 6 2 2 3 2
2 2 2 2 6 6 2 2 2 2 3 3 2 2 6 6 2 2 2 2 2 2 2 2 6 6 2 2 2 2 3 3 2 2 6 6 2 2 2 2 2 2 2 2 6 6 2 2 2 2 3 3 2 2 6 6 2 2 2 2 2 2 2 2 6 6 2 2 2 2 3 3 2 2 6 6 2 2 2 2 2 2 2 2 6 6 2 2 2 2 3 3 2 2 6 6 2 2 2 2
2 2 2 6 2 2 6 2 2 2 3 2 2 6 2 2 6 2 2 2 2 2 2 6 2 2 6 2 2 2 3 2 2 6 2 2 6 2 2 2 2 2 2 6 2 2 6 2 2 2 3 2 2 6 2 2 6 2 2 2 2 2 2 6 2 2 6 2 2 2 3 2 2 6 2 2 6 2 2 2 2 2 2 6 2 2 6 2 2 2 3 2 2 6 2 2 6 2 2 2
2 2 6 2 2 2 2 6 2 3 3 2 6 2 2 2 2 6 3 2 2 2 6 2 2 2 2 6 2 3 3 2 6 2 2 2 2 6 3 2 2 2 6 2 2 2 2 6 2 3 3 2 6 2 2 2 2 6 3 2 2 2 6 2 2 2 2 6 2 3 3 2 6 2 2 2 2 6 3 2 2 2 6 2 2 2 2 6 2 3 3 2 6 2 2 2 2 6 3 2
2 6 3 2 2 2 3 2 6 2 2 6 2 2 2 2 2 2 6 2 2 6 3 2 2 2 3 2 6 2 2 6 2 2 2 2 2 2 6 2 2 6 3 2 2 2 3 2 6 2 2 6 2 2 2 2 2 2 6 2 2 6 3 2 2 2 3 2 6 2 2 6 2 2 2 2 2 2 6 2 2 6 3 2 2 2 3 2 6 2 2 6 2 2 2 2 2 2 6 2
6 2 3 2 2 3 3 3 3 6 6 2 2 2 2 2 2 3 2 6 6 2 3 2 2 3 3 3 3 6 6 2 2 2 2 2 2 3 2 6 6 2 3 2 2 3 3 3 3 6 6 2 2 2 2 2 2 3 2 6 6 2 3 2 2 3 3 3 3 6 6 2 2 2 2 2 2 3 2 6 6 2 3 2 2 3 3 3 3 6 6 2 2 2 2 2 2 3 2 6
6 2 3 2 3 3 2 2 2 6 6 2 2 2 2 2 2 2 2 6 6 2 3 2 3 3 2 2 2 6 6 2 2 2 2 2 2 2 2 6 6 2 3 2 3 3 2 2 2 6 6 2 2 2 2 2 2 2 2 6 6 2 3 2 3 3 2 2 2 6 6 2 2 2 2 2 2 2 2 6 6 2 3 2 3 3 2 2 2 6 6 2 2 2 2 2 2 2 2 6
2 6 2 2 2 2 2 2 6 2 2 6 2 2 2 2 2 2 6 2 2 6 2 2 2 2 2 2 6 2 2 6 2 2 2 2 2 2 6 2 2 6 2 2 2 2 2 2 6 2 2 6 2 2 2 2 2 2 6 2 2 6 2 2 2 2 2 2 6 2 2 6 2 2 2 2 2 2 6 2 2 6 2 2 2 2 2 2 6 2 2 6 2 2 2 2 2 2 6 2
2 2 6 2 3 2 2 6 2 2 2 2 6 2 3 2 2 6 2 2 2 2 6 2 3 2 2 6 2 2 2 2 6 2 3 2 2 6 2 2 2 2 6 2 3 2 2 6 2 2 2 2 6 2 3 2 2 6 2 2 2 2 6 2 3 2 2 6 2 2 2 2 6 2 3 2 2 6 2 2 2 2 6 2 3 2 2 6 2 2 2 2 6 2 3 2 2 6 2 2
2 2 2 6 3 2 6 2 2 2 2 2 2 6 2 2 6 2 2 2 2 2 2 6 3 2 6 2 2 2 2 2 2 6 2 2 6 2 2 2 2 2 2 6 3 2 6 2 2 2 2 2 2 6 2 2 6 2 2 2 2 2 2 6 3 2 6 2 2 2 2 2 2 6 2 2 6 2 2 2 2 2 2 6 3 2 6 2 2 2 2 2 2 6 2 2 6 2 2 2
2 2 2 3 6 6 3 2 2 2 2 2 2 2 6 6 2 2 2 3 2 2 2 3 6 6 3 2 2 2 2 2 2 2 6 6 2 2 2 3 2 2 2 3 6 6 3 2 2 2 2 2 2 2 6 6 2 2 2 3 2 2 2 3 6 6 3 2 2 2 2 2 2 2 6 6 2 2 2 3 2 2 2 3 6 6 3 2 2 2 2 2 2 2 6 6 2 2 2 3
3 2 2 3 6 6 2 2 2 2 2 2 3 2 6 6 3 2 2 3 3 2 2 3 6 6 2 2 2 2 2 2 3 2 6 6 3 2 2 3 3 2 2 3 6 6 2 2 2 2 2 2 3 2 6 6 3 2 2 3 3 2 2 3 6 6 2 2 2 2 2 2 3 2 6 6 3 2 2 3 3 2 2 3 6 6 2 2 2 2 2 2 3 2 6 6 3 2 2 3
2 2 3 6 2 2 6 2 2 2 2 3 2 6 2 2 6 2 2 2 2 2 3 6 2 2 6 2 2 2 2 3 2 6 2 2 6 2 2 2 2 2 3 6 2 2 6 2 2 2 2 3 2 6 2 2 6 2 2 2 2 2 3 6 2 2 6 2 2 2 2 3 2 6 2 2 6 2 2 2 2 2 3 6 2 2 6 2 2 2 2 3 2 6 2 2 6 2 2 2
2 2 6 2 2 2 2 6 2 2 2 2 6 2 2 2 2 6 2 2 2 2 6 2 2 2 2 6 2 2 2 2 6 2 2 2 2 6 2 2 2 2 6 2 2 2 2 6 2 2 2 2 6 2 2 2 2 6 2 2 2 2 6 2 2 2 2 6 2 2 2 2 6 2 2 2 2 6 2 2 2 2 6 2 2 2 2 6 2 2 2 2 6 2 2 2 2 6 2 2
2 6 2 2 2 2 2 2 6 2 2 6 2 2 3 2 2 2 6 2 2 6 2 2 2 2 2 2 6 2 2 6 2 2 3 2 2 2 6 2 2 6 2 2 2 2 2 2 6 2 2 6 2 2 3 2 2 2 6 2 2 6 2 2 2 2 2 2 6 2 2 6 2 2 3 2 2 2 6 2 2 6 2 2 2 2 2 2 6 2 2 6 2 2 3 2 2 2 6 2
6 2 2 2 2 2 2 2 2 6 6 2 2 2 2 2 2 2 2 6 6 2 2 2 2 2 2 2 2 6 6 2 2 2 2 2 2 2 2 6 6 2 2 2 2 2 2 2 2 6 6 2 2 2 2 2 2 2 2 6 6 2 2 2 2 2 2 2 2 6 6 2 2 2 2 2 2 2 2 6 6 2 2 2 2 2 2 2 2 6 6 2 2 2 2 2 2 2 2 6
6 2 3 3 2 2 2 2 2 6 6 2 2 2 3 2 2 2 2 6 6 6 6 6 6 6 6 6 6 6 6 6 6 6 6 6 6 6 6 6 6 6 6 6 6 6 6 6 6 6 6 6 6 6 6 6 6 6 6 6 6 6 6 6 6 6 6 6 6 6 6 6 6 6 6 6 6 6 6 6 6 2 3 3 2 2 2 2 2 6 6 2 2 2 3 2 2 2 2 6
2 6 3 2 2 2 2 2 6 3 2 6 6 2 2 2 2 2 6 2 6 2 2 2 2 2 2 2 2 2 3 2 3 2 3 2 2 2 2 2 2 2 2 2 2 2 2 2 2 2 2 2 2 2 2 2 2 2 2 2 2 2 2 2 2 2 2 2 2 2 2 2 2 2 2 2 2 2 2 6 2 6 3 2 2 2 2 2 6 3 2 6 6 2 2 2 2 2 6 2
3 3 6 2 2 2 3 6 3 2 3 3 6 2 2 2 2 6 2 2 6 2 2 3 3 2 3 2 3 2 2 2 2 2 2 2 3 3 2 2 2 2 2 2 2 2 2 2 2 2 2 2 2 2 2 2 2 2 2 2 2 2 2 2 2 2 2 2 2 2 2 2 2 2 2 2 2 2 2 6 3 3 6 2 2 2 3 6 3 2 3 3 6 2 2 2 2 6 2 2
3 2 3 6 2 3 6 3 3 2 2 2 2 6 2 2 6 2 2 2 6 2 2 2 3 2 2 2 2 2 2 2 2 2 3 3 3 3 3 3 3 3 3 2 2 2 2 2 2 2 2 2 2 2 2 2 2 2 2 2 2 2 2 2 2 2 2 2 2 2 2 2 2 2 2 2 2 2 2 6 3 2 3 6 2 3 6 3 3 2 2 2 2 6 2 2 6 2 2 2
2 2 2 3 6 6 3 3 2 2 2 3 2 2 6 6 2 2 3 2 6 2 2 2 2 2 2 2 2 2 2 2 2 3 2 2 2 2 2 2 3 2 2 2 2 2 2 2 2 2 2 2 2 2 2 2 2 2 2 2 2 2 2 2 2 3 2 3 3 2 2 2 2 2 2 2 2 2 2 6 2 2 2 3 6 6 3 3 2 2 2 3 2 2 6 6 2 2 3 2
2 2 2 2 6 6 2 2 2 2 3 3 2 2 6 6 2 2 2 2 6 2 2 2 2 2 2 3 2 2 2 2 2 2 2 2 2 2 2 2 2 2 3 3 2 2 2 3 3 3 3 3 3 3 2 3 2 2 2 2 2 2 2 2 2 2 2 2 3 2 2 2 2 2 2 2 2 2 2 6 2 2 2 2 6 6 2 2 2 2 3 3 2 2 6 6 2 2 2 2
2 2 2 6 2 2 6 2 2 2 3 2 2 6 2 2 6 2 2 2 6 2 3 2 3 2 3 2 3 3 3 2 2 3 2 2 2 2 2 2 2 2 2 3 3 2 3 3 3 2 2 2 3 2 2 2 2 3 3 3 2 3 2 2 3 2 3 2 2 2 2 2 2 2 2 2 2 2 2 6 2 2 2 6 2 2 6 2 2 2 3 2 2 6 2 2 6 2 2 2
2 2 6 2 2 2 2 6 2 3 3 2 6 2 2 2 2 6 3 2 6 2 3 2 2 2 2 2 2 3 2 3 3 3 3 3 3 3 3 3 3 3 2 2 2 2 2 2 3 2 3 3 3 2 2 2 2 2 2 2 2 2 2 2 2 2 2 3 3 2 2 2 2 2 2 2 2 2 2 6 2 2 6 2 2 2 2 6 2 3 3 2 6 2 2 2 2 6 3 2
2 6 3 2 2 2 3 2 6 2 2 6 2 2 2 2 2 2 6 2 6 2 2 2 2 2 2 2 3 3 2 2 2 2 3 3 2 2 2 2 2 2 3 2 3 2 2 2 2 2 2 2 2 3 2 3 3 2 2 2 2 2 2 2 2 2 2 2 3 3 2 3 2 2 2 2 2 2 2 6 2 6 3 2 2 2 3 2 6 2 2 6 2 2 2 2 2 2 6 2
6 2 3 2 2 3 3 3 3 6 6 2 2 2 2 2 2 3 2 6 6 2 2 2 2 2 2 2 3 2 3 2 3 3 3 2 3 2 3 2 2 2 3 3 3 3 3 3 2 2 3 3 3 3 2 2 3 2 2 2 2 2 2 2 2 2 2 2 2 2 2 2 3 3 2 2 2 2 2 6 6 2 3 2 2 3 3 3 3 6 6 2 2 2 2 2 2 3 2 6
6 2 3 2 3 3 2 2 2 6 6 2 2 2 2 2 2 2 2 6 6 2 2 3 3 2 2 3 3 2 3 2 2 2 2 3 3 2 2 2 2 3 2 3 3 2 2 3 3 2 2 3 3 2 2 2 2 2 2 2 2 2 2 2 2 2 2 2 2 2 2 2 2 3 2 2 2 2 2 6 6 2 3 2 3 3 2 2 2 6 6 2 2 2 2 2 2 2 2 6
2 6 2 2 2 2 2 2 6 2 2 6 2 2 2 2 2 2 6 2 6 2 2 3 3 2 2 3 2 2 2 2 3 2 2 2 2 2 3 2 2 3 2 2 3 3 3 3 2 3 2 3 3 2 2 2 2 2 2 2 2 2 2 2 2 2 2 2 2 2 2 2 2 2 3 2 2 2 2 6 2 6 2 2 2 2 2 2 6 2 2 6 2 2 2 2 2 2 6 2
2 2 6 2 3 2 2 6 2 2 2 2 6 2 3 2 2 6 2 2 6 2 2 2 2 2 2 3 3 2 2 3 2 2 2 2 2 2 2 2 2 3 2 2 2 3 3 2 3 2 3 2 3 2 3 3 2 2 2 2 2 2 2 2 2 2 2 2 2 2 2 2 2 2 2 2 2 2 2 6 2 2 6 2 3 2 2 6 2 2 2 2 6 2 3 2 2 6 2 2
2 2 2 6 3 2 6 2 2 2 2 2 2 6 2 2 6 2 2 2 6 2 2 2 2 2 3 3 3 2 2 2 2 6 2 2 6 2 2 3 3 2 3 2 2 2 3 2 2 2 3 3 2 2 3 3 3 2 3 2 2 2 2 6 2 2 6 2 2 2 2 2 2 2 2 2 2 2 2 6 2 2 2 6 3 2 6 2 2 2 2 2 2 6 2 2 6 2 2 2
2 2 2 3 6 6 3 2 2 2 2 2 2 2 6 6 2 2 2 3 6 2 2 2 2 3 3 3 3 3 2 2 2 2 2 4 2 2 2 2 3 2 2 2 3 2 2 3 2 2 2 3 2 2 3 3 2 2 3 3 2 2 2 2 4 2 2 2 2 2 2 2 2 3 3 2 2 2 2 6 2 2 2 3 6 6 3 2 2 2 2 2 2 2 6 6 2 2 2 3
3 2 2 3 6 6 2 2 2 2 2 2 3 2 6 6 3 2 2 3 6 2 2 3 2 3 2 2 2 2 2 2 2 2 4 2 2 2 3 3 2 2 2 2 3 3 3 2 2 2 2 3 3 3 3 2 2 2 2 2 3 2 2 2 2 4 2 2 2 2 2 2 3 2 2 2 2 2 2 6 3 2 2 3 6 6 2 2 2 2 2 2 3 2 6 6 3 2 2 3
2 2 3 6 2 2 6 2 2 2 2 3 2 6 2 2 6 2 2 2 6 2 2 3 3 3 2 3 2 2 2 2 2 6 2 2 6 2 2 2 2 2 2 3 2 2 3 3 3 3 3 2 2 2 2 2 2 2 2 3 3 2 2 6 2 2 6 2 2 2 2 2 3 2 2 2 2 2 2 6 2 2 3 6 2 2 6 2 2 2 2 3 2 6 2 2 6 2 2 2
2 2 6 2 2 2 2 6 2 2 2 2 6 2 2 2 2 6 2 2 6 2 2 3 2 2 2 3 2 3 2 2 2 2 3 2 3 2 2 2 3 2 2 3 2 2 2 2 3 2 3 2 2 2 3 2 2 2 3 3 3 2 2 2 2 2 2 2 2 2 2 2 2 2 2 2 2 2 2 6 2 2 6 2 2 2 2 6 2 2 2 2 6 2 2 2 2 6 2 2
2 6 2 2 2 2 2 2 6 2 2 6 2 2 3 2 2 2 6 2 6 2 2 2 3 2 2 2 2 3 2 2 3 2 2 2 2 2 2 2 3 2 3 3 2 2 2 3 3 2 3 3 3 2 3 2 2 2 3 3 3 2 2 2 2 2 2 2 2 2 3 3 2 2 2 2 2 2 2 6 2 6 2 2 2 2 2 2 6 2 2 6 2 2 3 2 2 2 6 2
6 2 2 2 2 2 2 2 2 6 6 2 2 2 2 2 2 2 2 6 6 2 2 3 3 3 3 2 2 2 2 3 2 3 2 2 2 2 2 2 3 2 3 2 2 2 3 3 2 3 2 2 3 3 3 3 2 2 2 2 2 3 2 3 2 2 2 3 3 3 2 2 3 2 2 2 2 2 2 6 6 2 2 2 2 2 2 2 2 6 6 2 2 2 2 2 2 2 2 6
6 2 3 3 2 2 2 2 2 6 6 2 2 2 3 2 2 2 2 6 6 2 2 3 2 2 3 3 3 2 2 3 2 2 3 2 2 2 2 2 2 2 2 2 2 3 3 2 3 2 2 2 2 2 2 2 2 3 3 2 2 2 2 2 2 3 2 3 2 2 3 2 3 2 3 2 2 2 2 6 6 2 3 3 2 2 2 2 2 6 6 2 2 2 3 2 2 2 2 6
2 6 3 2 2 2 2 2 6 3 2 6 6 2 2 2 2 2 6 2 6 2 2 2 3 2 2 3 3 3 3 3 2 3 3 3 3 2 2 2 3 3 3 2 3 3 2 2 2 3 2 2 2 2 2 2 3 2 2 2 2 2 2 3 2 3 2 2 2 2 3 2 2 2 2 3 2 2 2 6 2 6 3 2 2 2 2 2 6 3 2 6 6 2 2 2 2 2 6 2
3 3 6 2 2 2 3 6 3 2 3 3 6 2 2 2 2 6 2 2 6 2 3 2 3 2 2 2 2 3 2 2 3 3 2 3 2 3 2 2 3 3 3 3 3 2 2 3 2 3 2 3 2 2 3 3 3 3 2 3 2 3 3 2 2 2 2 3 2 2 3 2 2 2 2 3 2 2 2 6 3 3 6 2 2 2 3 6 3 2 3 3 6 2 2 2 2 6 2 2
3 2 3 6 2 3 6 3 3 2 2 2 2 6 2 2 6 2 2 2 6 2 2 3 3 2 3 2 2 2 2 2 3 3 2 2 2 2 3 3 2 3 3 3 3 3 2 2 2 3 2 2 3 2 3 3 2 3 2 2 3 3 2 2 3 2 3 2 2 3 3 2 2 2 2 2 2 2 2 6 3 2 3 6 2 3 6 3 3 2 2 2 2 6 2 2 6 2 2 2
2 2 2 3 6 6 3 3 2 2 2 3 2 2 6 6 2 2 3 2 6 2 2 2 3 2 3 2 2 2 2 2 2 2 3 3 2 2 3 3 2 3 2 3 3 2 2 3 2 3 2 2 2 2 2 3 2 2 2 2 2 2 3 2 2 2 2 2 3 3 2 2 2 2 3 2 2 2 2 6 2 2 2 3 6 6 3 3 2 2 2 3 2 2 6 6 2 2 3 2
2 2 2 2 6 6 2 2 2 2 3 3 2 2 6 6 2 2 2 2 6 2 2 2 3 3 2 2 2 3 2 2 2 3 2 2 2 3 3 3 2 3 3 2 3 2 3 2 2 2 2 2 2 2 2 3 2 2 2 2 2 2 2 3 3 2 2 3 2 3 2 2 2 2 2 2 3 2 2 6 2 2 2 2 6 6 2 2 2 2 3 3 2 2 6 6 2 2 2 2
2 2 2 6 2 2 6 2 2 2 3 2 2 6 2 2 6 2 2 2 6 2 2 3 3 2 2 2 3 2 2 2 3 3 3 3 2 2 3 3 3 3 2 2 3 2 2 2 2 2 2 2 2 2 2 2 2 2 2 3 2 2 3 2 3 2 2 2 2 3 2 2 2 2 3 3 2 2 2 6 2 2 2 6 2 2 6 2 2 2 3 2 2 6 2 2 6 2 2 2
2 2 6 2 2 2 2 6 2 3 3 2 6 2 2 2 2 6 3 2 6 2 2 2 2 2 6 2 2 3 2 3 2 2 3 2 2 2 3 3 3 2 3 2 2 3 2 6 2 2 2 2 6 2 3 3 2 2 2 3 2 2 3 3 2 2 3 3 3 2 3 3 2 6 2 3 2 2 2 6 2 2 6 2 2 2 2 6 2 3 3 2 6 2 2 2 2 6 3 2
2 6 3 2 2 2 3 2 6 2 2 6 2 2 2 2 2 2 6 2 6 2 3 3 2 2 4 2 3 3 2 2 3 3 3 3 3 3 3 2 2 3 2 2 2 2 2 2 4 2 2 4 2 2 2 2 3 3 3 2 2 2 2 3 2 2 3 3 2 2 2 3 3 4 2 2 2 2 2 6 2 6 3 2 2 2 3 2 6 2 2 6 2 2 2 2 2 2 6 2
6 2 3 2 2 3 3 3 3 6 6 2 2 2 2 2 2 3 2 6 6 2 3 2 3 2 4 3 3 2 3 2 3 2 2 3 3 2 2 2 2 3 2 2 3 2 2 3 2 2 4 2 2 2 3 3 2 2 3 3 2 3 2 2 2 3 3 3 3 2 2 2 2 4 2 2 3 2 2 6 6 2 3 2 2 3 3 3 3 6 6 2 2 2 2 2 2 3 2 6
6 2 3 2 3 3 2 2 2 6 6 2 2 2 2 2 2 2 2 6 6 2 2 2 3 2 4 2 2 2 2 2 3 2 3 2 3 2 2 2 2 2 2 2 3 2 2 3 2 4 2 2 3 2 2 2 3 3 2 3 2 3 3 3 2 3 2 2 2 3 2 3 3 4 2 2 3 2 2 6 6 2 3 2 3 3 2 2 2 6 6 2 2 2 2 2 2 2 2 6
2 6 2 2 2 2 2 2 6 2 2 6 2 2 2 2 2 2 6 2 6 2 3 2 2 2 4 2 2 2 2 2 3 2 2 2 2 3 2 2 2 2 2 3 3 3 2 2 4 2 2 4 2 2 2 3 2 2 2 3 2 2 2 3 2 3 2 2 2 2 3 2 2 4 2 2 2 2 2 6 2 6 2 2 2 2 2 2 6 2 2 6 2 2 2 2 2 2 6 2
2 2 6 2 3 2 2 6 2 2 2 2 6 2 3 2 2 6 2 2 6 2 3 2 2 2 6 2 2 2 2 2 3 3 3 2 2 3 3 2 3 3 2 2 3 3 2 6 2 2 2 2 6 2 2 2 2 2 2 2 2 2 2 2 3 3 2 2 2 2 2 2 2 6 2 3 2 3 2 6 2 2 6 2 3 2 2 6 2 2 2 2 6 2 3 2 2 6 2 2
2 2 2 6 3 2 6 2 2 2 2 2 2 6 2 2 6 2 2 2 6 2 2 3 2 2 2 2 3 3 2 2 2 2 3 2 3 3 2 3 3 2 2 2 2 2 2 2 2 2 2 2 2 2 2 2 2 2 2 2 2 2 3 2 3 3 2 2 3 3 3 2 2 2 2 2 2 2 2 6 2 2 2 6 3 2 6 2 2 2 2 2 2 6 2 2 6 2 2 2
2 2 2 3 6 6 3 2 2 2 2 2 2 2 6 6 2 2 2 3 6 2 2 3 3 2 2 3 3 2 2 2 2 3 2 2 2 2 2 3 2 2 3 3 2 2 3 3 2 2 2 2 2 3 2 2 2 3 2 3 2 2 2 2 2 2 3 2 3 2 2 3 3 2 2 2 2 3 2 6 2 2 2 3 6 6 3 2 2 2 2 2 2 2 6 6 2 2 2 3
3 2 2 3 6 6 2 2 2 2 2 2 3 2 6 6 3 2 2 3 6 2 2 2 3 2 2 2 2 3 2 2 3 2 2 2 2 3 3 3 2 2 3 2 3 3 3 3 2 2 2 2 3 2 2 2 2 3 3 2 2 2 3 3 2 3 2 3 2 2 3 2 2 2 2 2 3 3 2 6 3 2 2 3 6 6 2 2 2 2 2 2 3 2 6 6 3 2 2 3
2 2 3 6 2 2 6 2 2 2 2 3 2 6 2 2 6 2 2 2 6 2 3 3 2 2 2 3 3 3 2 2 3 3 2 2 3 2 2 2 3 2 2 3 2 2 2 3 3 3 3 2 2 2 3 2 2 2 3 2 2 3 2 2 3 2 2 2 2 2 3 2 2 3 2 2 2 2 2 6 2 2 3 6 2 2 6 2 2 2 2 3 2 6 2 2 6 2 2 2
2 2 6 2 2 2 2 6 2 2 2 2 6 2 2 2 2 6 2 2 6 2 3 3 3 2 3 2 3 2 2 2 2 3 2 2 3 2 2 2 2 3 3 2 2 2 3 2 2 2 3 2 2 2 2 2 2 2 2 2 2 2 3 3 3 2 2 2 3 2 3 2 3 3 2 2 3 2 2 6 2 2 6 2 2 2 2 6 2 2 2 2 6 2 2 2 2 6 2 2
2 6 2 2 2 2 2 2 6 2 2 6 2 2 3 2 2 2 6 2 6 2 2 3 2 2 3 3 2 2 2 2 3 2 2 3 3 2 3 2 2 2 3 3 3 2 2 2 3 2 3 3 2 2 3 2 2 2 3 2 2 2 2 2 2 2 2 2 2 2 3 3 2 2 2 2 3 2 2 6 2 6 2 2 2 2 2 2 6 2 2 6 2 2 3 2 2 2 6 2
6 2 2 2 2 2 2 2 2 6 6 2 2 2 2 2 2 2 2 6 6 2 3 3 2 3 2 2 2 2 2 2 2 2 2 3 3 2 3 2 2 2 3 2 2 2 2 2 2 2 3 3 2 3 2 2 2 2 2 3 2 2 3 2 2 2 3 2 2 2 2 3 2 3 2 3 3 2 2 6 6 2 2 2 2 2 2 2 2 6 6 2 2 2 2 2 2 2 2 6
6 2 3 3 2 2 2 2 2 6 6 2 2 2 3 2 2 2 2 6 6 2 3 3 3 3 2 2 2 2 2 3 2 2 2 3 2 2 2 2 2 3 2 3 2 2 2 3 3 2 2 3 2 2 2 2 2 2 2 2 2 3 2 2 3 2 2 2 2 2 2 3 2 2 3 2 2 2 2 6 6 2 3 3 2 2 2 2 2 6 6 2 2 2 3 2 2 2 2 6
2 6 3 2 2 2 2 2 6 3 2 6 6 2 2 2 2 2 6 2 6 2 2 2 2 3 2 2 2 2 2 2 2 2 2 2 2 2 2 2 2 3 2 3 2 2 3 2 2 3 3 2 3 2 2 2 2 3 2 2 3 2 2 2 2 2 2 2 2 2 3 3 2 3 2 2 2 2 2 6 2 6 3 2 2 2 2 2 6 3 2 6 6 2 2 2 2 2 6 2
3 3 6 2 2 2 3 6 3 2 3 3 6 2 2 2 2 6 2 2 6 2 2 3 2 2 2 2 2 2 2 2 2 2 2 2 2 2 3 2 2 2 2 3 2 2 2 2 2 2 2 2 3 2 2 3 2 2 2 3 3 2 2 2 2 2 2 2 2 2 2 3 2 2 2 2 2 2 2 6 3 3 6 2 2 2 3 6 3 2 3 3 6 2 2 2 2 6 2 2
3 2 3 6 2 3 6 3 3 2 2 2 2 6 2 2 6 2 2 2 6 2 2 2 2 2 2 2 2 2 2 2 2 6 2 2 6 2 2 2 2 2 2 2 2 3 2 2 2 2 2 2 3 2 2 3 2 3 2 2 2 2 2 6 2 2 6 2 2 2 2 2 3 3 2 2 2 2 2 6 3 2 3 6 2 3 6 3 3 2 2 2 2 6 2 2 6 2 2 2
2 2 2 3 6 6 3 3 2 2 2 3 2 2 6 6 2 2 3 2 6 2 2 2 2 2 3 2 2 2 2 2 2 2 4 2 2 2 2 2 3 2 2 2 3 2 3 2 2 3 3 2 2 2 3 3 2 2 2 2 2 2 2 2 2 4 2 3 3 2 3 2 2 2 3 2 2 2 2 6 2 2 2 3 6 6 3 3 2 2 2 3 2 2 6 6 2 2 3 2
2 2 2 2 6 6 2 2 2 2 3 3 2 2 6 6 2 2 2 2 6 2 2 3 2 2 2 2 2 2 2 2 2 2 2 4 2 2 2 2 2 2 2 2 3 3 2 2 2 2 3 2 3 2 2 2 2 2 3 3 3 2 2 2 4 2 3 3 2 2 3 2 2 2 2 2 2 2 2 6 2 2 2 2 6 6 2 2 2 2 3 3 2 2 6 6 2 2 2 2
2 2 2 6 2 2 6 2 2 2 3 2 2 6 2 2 6 2 2 2 6 2 2 2 2 2 2 2 2 2 2 2 2 6 2 2 6 2 2 2 2 2 2 2 2 3 3 3 3 2 3 2 3 3 2 2 2 2 2 2 3 3 2 6 2 2 6 2 2 2 3 2 2 2 3 2 2 2 2 6 2 2 2 6 2 2 6 2 2 2 3 2 2 6 2 2 6 2 2 2
2 2 6 2 2 2 2 6 2 3 3 2 6 2 2 2 2 6 3 2 6 2 2 3 2 3 2 2 2 2 2 2 2 2 2 2 2 2 2 2 2 2 2 2 2 2 3 2 3 2 2 2 2 2 3 2 2 2 2 2 2 2 2 2 3 2 3 3 2 2 2 2 2 3 3 2 2 2 2 6 2 2 6 2 2 2 2 6 2 3 3 2 6 2 2 2 2 6 3 2
2 6 3 2 2 2 3 2 6 2 2 6 2 2 2 2 2 2 6 2 6 2 2 3 2 3 2 3 2 2 2 2 2 2 2 2 2 2 2 2 2 2 2 2 2 2 3 2 2 2 2 2 2 3 2 2 3 2 2 2 3 2 2 2 2 3 2 3 2 2 2 2 2 3 2 2 2 2 2 6 2 6 3 2 2 2 3 2 6 2 2 6 2 2 2 2 2 2 6 2
6 2 3 2 2 3 3 3 3 6 6 2 2 2 2 2 2 3 2 6 6 2 2 3 2 2 2 2 3 2 2 2 2 3 2 2 3 2 2 2 2 2 2 3 2 3 2 2 2 2 2 2 3 3 2 2 2 2 3 2 2 2 3 3 2 2 2 2 2 2 2 2 3 2 2 2 2 2 2 6 6 2 3 2 2 3 3 3 3 6 6 2 2 2 2 2 2 3 2 6
6 2 3 2 3 3 2 2 2 6 6 2 2 2 2 2 2 2 2 6 6 2 3 2 3 2 2 2 3 2 2 2 2 3 3 2 2 3 2 2 3 2 2 2 3 2 2 2 3 3 2 3 2 3 2 2 3 3 2 2 2 2 2 3 3 2 2 2 2 2 2 2 2 3 2 2 2 2 2 6 6 2 3 2 3 3 2 2 2 6 6 2 2 2 2 2 2 2 2 6
2 6 2 2 2 2 2 2 6 2 2 6 2 2 2 2 2 2 6 2 6 2 2 2 2 2 2 3 2 2 2 2 2 2 2 2 2 2 2 2 3 2 2 3 3 2 2 2 2 2 3 2 2 2 3 2 2 3 2 2 2 3 2 2 3 2 2 3 2 2 2 3 3 2 2 2 2 2 2 6 2 6 2 2 2 2 2 2 6 2 2 6 2 2 2 2 2 2 6 2
2 2 6 2 3 2 2 6 2 2 2 2 6 2 3 2 2 6 2 2 6 2 2 3 2 3 3 2 2 2 2 3 2 2 2 3 2 2 2 2 3 3 2 3 3 3 2 3 3 2 2 3 3 2 2 2 2 3 2 2 2 2 2 2 2 2 3 2 2 3 2 3 3 3 2 2 2 2 2 6 2 2 6 2 3 2 2 6 2 2 2 2 6 2 3 2 2 6 2 2
2 2 2 6 3 2 6 2 2 2 2 2 2 6 2 2 6 2 2 2 6 2 3 3 2 2 2 2 2 3 3 2 2 3 2 3 2 3 3 2 2 2 2 2 2 3 3 3 3 3 3 3 3 2 2 2 2 2 2 2 2 3 3 3 2 2 2 2 3 2 2 2 2 3 2 2 2 2 2 6 2 2 2 6 3 2 6 2 2 2 2 2 2 6 2 2 6 2 2 2
2 2 2 3 6 6 3 2 2 2 2 2 2 2 6 6 2 2 2 3 6 2 2 3 2 3 3 2 3 2 2 2 3 3 3 2 2 3 2 2 2 2 2 2 2 3 2 3 3 2 2 2 2 2 3 2 2 2 3 3 2 2 3 2 2 2 2 2 3 2 2 3 2 2 2 3 2 2 2 6 2 2 2 3 6 6 3 2 2 2 2 2 2 2 6 6 2 2 2 3
3 2 2 3 6 6 2 2 2 2 2 2 3 2 6 6 3 2 2 3 6 2 2 3 3 3 2 3 3 2 2 2 2 2 2 2 3 2 2 2 2 2 2 3 2 2 2 2 2 2 2 3 2 2 2 2 2 2 3 2 2 3 3 2 2 2 2 2 2 3 3 3 2 2 3 3 2 2 2 6 3 2 2 3 6 6 2 2 2 2 2 2 3 2 6 6 3 2 2 3
2 2 3 6 2 2 6 2 2 2 2 3 2 6 2 2 6 2 2 2 6 2 2 3 2 3 2 3 2 3 3 3 2 2 2 2 2 2 3 2 3 2 2 3 3 3 2 2 2 2 2 2 2 3 3 2 2 2 3 3 2 2 2 3 2 2 3 2 2 3 3 2 3 2 3 3 3 2 3 6 2 2 3 6 2 2 6 2 2 2 2 3 2 6 2 2 6 2 2 2
2 2 6 2 2 2 2 6 2 2 2 2 6 2 2 2 2 6 2 2 6 2 2 2 3 3 2 2 2 2 2 2 2 2 3 3 2 2 2 2 2 2 2 2 2 2 2 3 2 2 2 3 2 2 3 3 2 2 3 2 2 2 2 2 2 2 2 2 2 2 2 2 3 2 3 2 2 2 3 6 2 2 6 2 2 2 2 6 2 2 2 2 6 2 2 2 2 6 2 2
2 6 2 2 2 2 2 2 6 2 2 6 2 2 3 2 2 2 6 2 6 2 2 2 2 3 2 2 2 2 2 2 2 2 2 2 2 2 2 2 2 2 2 2 2 2 2 2 2 2 3 2 2 2 2 2 2 2 2 2 2 2 2 2 2 2 2 2 2 2 2 2 2 2 2 3 2 2 2 6 2 6 2 2 2 2 2 2 6 2 2 6 2 2 3 2 2 2 6 2
6 2 2 2 2 2 2 2 2 6 6 2 2 2 2 2 2 2 2 6 6 6 6 6 6 6 6 6 6 6 6 6 6 6 6 6 6 6 6 6 6 6 6 6 6 6 6 6 6 6 6 6 6 6 6 6 6 6 6 6 6 6 6 6 6 6 6 6 6 6 6 6 6 6 6 6 6 6 6 6 6 2 2 2 2 2 2 2 2 6 6 2 2 2 2 2 2 2 2 6
6 2 3 3 2 2 2 2 2 6 6 2 2 2 3 2 2 2 2 6 6 2 3 3 2 2 2 2 2 6 6 2 2 2 3 2 2 2 2 6 6 2 3 3 2 2 2 2 2 6 6 2 2 2 3 2 2 2 2 6 6 2 3 3 2 2 2 2 2 6 6 2 2 2 3 2 2 2 2 6 6 2 3 3 2 2 2 2 2 6 6 2 2 2 3 2 2 2 2 6
2 6 3 2 2 2 2 2 6 3 2 6 6 2 2 2 2 2 6 2 2 6 3 2 2 2 2 2 6 3 2 6 6 2 2 2 2 2 6 2 2 6 3 2 2 2 2 2 6 3 2 6 6 2 2 2 2 2 6 2 2 6 3 2 2 2 2 2 6 3 2 6 6 2 2 2 2 2 6 2 2 6 3 2 2 2 2 2 6 3 2 6 6 2 2 2 2 2 6 2
3 3 6 2 2 2 3 6 3 2 3 3 6 2 2 2 2 6 2 2 3 3 6 2 2 2 3 6 3 2 3 3 6 2 2 2 2 6 2 2 3 3 6 2 2 2 3 6 3 2 3 3 6 2 2 2 2 6 2 2 3 3 6 2 2 2 3 6 3 2 3 3 6 2 2 2 2 6 2 2 3 3 6 2 2 2 3 6 3 2 3 3 6 2 2 2 2 6 2 2
3 2 3 6 2 3 6 3 3 2 2 2 2 6 2 2 6 2 2 2 3 2 3 6 2 3 6 3 3 2 2 2 2 6 2 2 6 2 2 2 3 2 3 6 2 3 6 3 3 2 2 2 2 6 2 2 6 2 2 2 3 2 3 6 2 3 6 3 3 2 2 2 2 6 2 2 6 2 2 2 3 2 3 6 2 3 6 3 3 2 2 2 2 6 2 2 6 2 2 2
2 2 2 3 6 6 3 3 2 2 2 3 2 2 6 6 2 2 3 2 2 2 2 3 6 6 3 3 2 2 2 3 2 2 6 6 2 2 3 2 2 2 2 3 6 6 3 3 2 2 2 3 2 2 6 6 2 2 3 2 2 2 2 3 6 6 3 3 2 2 2 3 2 2 6 6 2 2 3 2 2 2 2 3 6 6 3 3 2 2 2 3 2 2 6 6 2 2 3 2
2 2 2 2 6 6 2 2 2 2 3 3 2 2 6 6 2 2 2 2 2 2 2 2 6 6 2 2 2 2 3 3 2 2 6 6 2 2 2 2 2 2 2 2 6 6 2 2 2 2 3 3 2 2 6 6 2 2 2 2 2 2 2 2 6 6 2 2 2 2 3 3 2 2 6 6 2 2 2 2 2 2 2 2 6 6 2 2 2 2 3 3 2 2 6 6 2 2 2 2
2 2 2 6 2 2 6 2 2 2 3 2 2 6 2 2 6 2 2 2 2 2 2 6 2 2 6 2 2 2 3 2 2 6 2 2 6 2 2 2 2 2 2 6 2 2 6 2 2 2 3 2 2 6 2 2 6 2 2 2 2 2 2 6 2 2 6 2 2 2 3 2 2 6 2 2 6 2 2 2 2 2 2 6 2 2 6 2 2 2 3 2 2 6 2 2 6 2 2 2
2 2 6 2 2 2 2 6 2 3 3 2 6 2 2 2 2 6 3 2 2 2 6 2 2 2 2 6 2 3 3 2 6 2 2 2 2 6 3 2 2 2 6 2 2 2 2 6 2 3 3 2 6 2 2 2 2 6 3 2 2 2 6 2 2 2 2 6 2 3 3 2 6 2 2 2 2 6 3 2 2 2 6 2 2 2 2 6 2 3 3 2 6 2 2 2 2 6 3 2
2 6 3 2 2 2 3 2 6 2 2 6 2 2 2 2 2 2 6 2 2 6 3 2 2 2 3 2 6 2 2 6 2 2 2 2 2 2 6 2 2 6 3 2 2 2 3 2 6 2 2 6 2 2 2 2 2 2 6 2 2 6 3 2 2 2 3 2 6 2 2 6 2 2 2 2 2 2 6 2 2 6 3 2 2 2 3 2 6 2 2 6 2 2 2 2 2 2 6 2
6 2 3 2 2 3 3 3 3 6 6 2 2 2 2 2 2 3 2 6 6 2 3 2 2 3 3 3 3 6 6 2 2 2 2 2 2 3 2 6 6 2 3 2 2 3 3 3 3 6 6 2 2 2 2 2 2 3 2 6 6 2 3 2 2 3 3 3 3 6 6 2 2 2 2 2 2 3 2 6 6 2 3 2 2 3 3 3 3 6 6 2 2 2 2 2 2 3 2 6
6 2 3 2 3 3 2 2 2 6 6 2 2 2 2 2 2 2 2 6 6 2 3 2 3 3 2 2 2 6 6 2 2 2 2 2 2 2 2 6 6 2 3 2 3 3 2 2 2 6 6 2 2 2 2 2 2 2 2 6 6 2 3 2 3 3 2 2 2 6 6 2 2 2 2 2 2 2 2 6 6 2 3 2 3 3 2 2 2 6 6 2 2 2 2 2 2 2 2 6
2 6 2 2 2 2 2 2 6 2 2 6 2 2 2 2 2 2 6 2 2 6 2 2 2 2 2 2 6 2 2 6 2 2 2 2 2 2 6 2 2 6 2 2 2 2 2 2 6 2 2 6 2 2 2 2 2 2 6 2 2 6 2 2 2 2 2 2 6 2 2 6 2 2 2 2 2 2 6 2 2 6 2 2 2 2 2 2 6 2 2 6 2 2 2 2 2 2 6 2
2 2 6 2 3 2 2 6 2 2 2 2 6 2 3 2 2 6 2 2 2 2 6 2 3 2 2 6 2 2 2 2 6 2 3 2 2 6 2 2 2 2 6 2 3 2 2 6 2 2 2 2 6 2 3 2 2 6 2 2 2 2 6 2 3 2 2 6 2 2 2 2 6 2 3 2 2 6 2 2 2 2 6 2 3 2 2 6 2 2 2 2 6 2 3 2 2 6 2 2
2 2 2 6 3 2 6 2 2 2 2 2 2 6 2 2 6 2 2 2 2 2 2 6 3 2 6 2 2 2 2 2 2 6 2 2 6 2 2 2 2 2 2 6 3 2 6 2 2 2 2 2 2 6 2 2 6 2 2 2 2 2 2 6 3 2 6 2 2 2 2 2 2 6 2 2 6 2 2 2 2 2 2 6 3 2 6 2 2 2 2 2 2 6 2 2 6 2 2 2
2 2 2 3 6 6 3 2 2 2 2 2 2 2 6 6 2 2 2 3 2 2 2 3 6 6 3 2 2 2 2 2 2 2 6 6 2 2 2 3 2 2 2 3 6 6 3 2 2 2 2 2 2 2 6 6 2 2 2 3 2 2 2 3 6 6 3 2 2 2 2 2 2 2 6 6 2 2 2 3 2 2 2 3 6 6 3 2 2 2 2 2 2 2 6 6 2 2 2 3
3 2 2 3 6 6 2 2 2 2 2 2 3 2 6 6 3 2 2 3 3 2 2 3 6 6 2 2 2 2 2 2 3 2 6 6 3 2 2 3 3 2 2 3 6 6 2 2 2 2 2 2 3 2 6 6 3 2 2 3 3 2 2 3 6 6 2 2 2 2 2 2 3 2 6 6 3 2 2 3 3 2 2 3 6 6 2 2 2 2 2 2 3 2 6 6 3 2 2 3
2 2 3 6 2 2 6 2 2 2 2 3 2 6 2 2 6 2 2 2 2 2 3 6 2 2 6 2 2 2 2 3 2 6 2 2 6 2 2 2 2 2 3 6 2 2 6 2 2 2 2 3 2 6 2 2 6 2 2 2 2 2 3 6 2 2 6 2 2 2 2 3 2 6 2 2 6 2 2 2 2 2 3 6 2 2 6 2 2 2 2 3 2 6 2 2 6 2 2 2
2 2 6 2 2 2 2 6 2 2 2 2 6 2 2 2 2 6 2 2 2 2 6 2 2 2 2 6 2 2 2 2 6 2 2 2 2 6 2 2 2 2 6 2 2 2 2 6 2 2 2 2 6 2 2 2 2 6 2 2 2 2 6 2 2 2 2 6 2 2 2 2 6 2 2 2 2 6 2 2 2 2 6 2 2 2 2 6 2 2 2 2 6 2 2 2 2 6 2 2
2 6 2 2 2 2 2 2 6 2 2 6 2 2 3 2 2 2 6 2 2 6 2 2 2 2 2 2 6 2 2 6 2 2 3 2 2 2 6 2 2 6 2 2 2 2 2 2 6 2 2 6 2 2 3 2 2 2 6 2 2 6 2 2 2 2 2 2 6 2 2 6 2 2 3 2 2 2 6 2 2 6 2 2 2 2 2 2 6 2 2 6 2 2 3 2 2 2 6 2
6 2 2 2 2 2 2 2 2 6 6 2 2 2 2 2 2 2 2 6 6 2 2 2 2 2 2 2 2 6 6 2 2 2 2 2 2 2 2 6 6 2 2 2 2 2 2 2 2 6 6 2 2 2 2 2 2 2 2 6 6 2 2 2 2 2 2 2 2 6 6 2 2 2 2 2 2 2 2 6 6 2 2 2 2 2 2 2 2 6 6 2 2 2 2 2 2 2 2 6